NO ./textures/blue.xpm

SO ./textures/brick.xpm

WE ./textures/grey.xpm

EA ./textures/wood.xpm

F 220,100,0

C 225,30,0

111111111111111111111111
100000000000000000000001
1010N0000000000000000001
100100000000000000000001
100010000000000000100001
100000000000000HHH000001
100000000000000000000001
100010000000000000000001
100000000000000000000001
1000000000H0000000000001
100000000000000000DDDDD1
100000001001000000000001
100000000000000000000001
1000000111111100D00000D1
1000000100000100D0000001
1000000100000100D0000001
10000001C11C110000000001
100000000000000000000001
1000000000D0000H00000001
10000000001000D00000D001
10000000000000000000D001
100D0000000000000000D001
100000000000000000000001
111111111111111111111111