NO ./path_to_the_north_texture

SO ./path_to_the_south_texture

WE ./path_to_the_west_texture

EA ./path_to_the_east_texture

F 220,100,0

C 225,30,0

1111111111111111111111111     111111111111
10000000001100000000000001
1011000001110000000000001
10010000000001C100000001
1111111110110000011100001
100000000011000001110111111111111
11110111111111011100000010D01
11110111111011011101010010001
11000000111111011100000010001
10000000000111001100000010001
10000000000000001101010010001      111
11000001110101011111011110N0111    101
11110111 1110101 101111010001      111
11111111 1111111 111111111111