NO ./textures/blue.xpm

SO ./textures/brick.xpm

WE ./textures/grey.xpm

EA ./textures/wood.xpm

F 220,100,0

C 225,30,0

111111111111111111111111111111111111111111
1000000000110000000000000000000000000000W1
1011000001110000H0000000111111111111111111
1001000000000000000000001
1111111110110000011100001
100000000011000001110111111111111
11110111111111011100000010D01
11110111111011011101010010001
11000000111111011100000010001
10000000000111001100000010001
10000000000000001101010010001      111
1100000111010101111101111000111    101
11110111 1110101 101111010001      111
11111111 1111111 111111111111