NO ./path_to_the_north_texture

SO ./path_to_the_south_texture

WE ./path_to_the_west_texture

EA ./path_to_the_east_texture

F 220,100,0

C 225,30,0

1111111111111111111111111111111111111111111111111111
1000000000110000000000000000000000000000000000000N01
1000000001110000000000001111111111111111111111111111
1001000000000000000000001
1111111110110000011100001
100000000011000001110111111111111
11110111111111011100000010001
11110111111011011101010010001
11000000111111011100000010001
10000000000111001100000010001
10000000000000001101010010001      111
1100000101010101011101111000111    101
10000000000000000000000000001      111
11111111111111111111111111111
1              101          1
11111111111111111111111111111
10000000000000000000000000001      111
11111111111111111111111111111
10000000000000000000000000001      111
11111111111111111111111111111
10000000000000000000000000001      111
11111111111111111111111111111
10000000000000000000000000001      111
11111111111111111111111111111
10000000000000000000000000001      111
11111111111111111111111111111
10000000000000000000000000001      111
11111111111111111111111111111
10000000000000000000000000001      111
11111111111111111111111111111
10000000000000000000000000001      111
11111111111111111111111111111
10000000000000000000000000001      111
11111111111111111111111111111
10000000000000000000000000001      111
11111111111111111111111111111
10000000000000000000000000001      111
11111111111111111111111111111
10000000000000000000000000001      111
11111111111111111111111111111
10000000000000000000000000001      111
11111111111111111111111111111
10000000000000000000000000001      111
11111111111111111111111111111
10000000000000000000000000001      111
11111111111111111111111111111