NO ./textures/blue.xpm

SO ./textures/brick.xpm

WE ./textures/grey.xpm

EA ./textures/wood.xpm

F 220,100,0

C 225,30,0

111111111111111111111111
100000000000000000000001
1010N0000000000000000001
100100000000000000000001
10001000000H000000100001
100000000000000000000001
100000D00000D00000000001
100010000000000000000001
100000000000000000000001
100000000000000000000001
100000000000000000000001
100000001001000000000001
100000000000000000000001
1000000111C1C10000000001
100000010000010000000001
100000010000010000000001
100000010110110000000001
100000000000000000000001
100000000000000000000001
100000000010000000000001
100000000000000000000001
100000000000000000000001
100000000000000000000001
111111111111111111111111