NO ./pat1_to_t1e_nort1_texture

SO ./pat1_to_t1e_sout1_texture

WE ./pat1_to_t1e_west_texture

EA ./pat1_to_t1e_east_texture

F 220,100,0

C 225,30,0

111111111111111111111111111111111111111111111111111111111111111111111111111111111111111111
100000000000000000000000000000000000000000000000000000000000000000000000000000000000000001
101000000000000000000000100000000000000000000010000000000000000000001000000000000000000001
100100000000000000000000010000000000000000000001000000000000000000000100000000000000000001
100010000000000000100000001000000000000010000000100000000000001000000010000000000000100001
100000000000000000000000000000000000000000000000000000000000000000000000000000000000000001
100000000000000000000000000000000000000000000000000000000000000000000000000000000000000001
100010000000000000000000001000000000000000000000100000000000000000000010000000000000000001
100000000000000000000000000000000000000000000000000000000000000000000000000000000000000001
100000000000000000000000000000000000000000000000000000000000000000000000000000000000000001
100000000000000000DDDDD00000000000000000DDDDD00000000000000000DDDDD00000000000000000DDDDD1
10000000100100000000000000000010E100000000000000000010010000000000000000001001000000000001
100000000000000000000000000000000000000000000000000000000000000000000000000000000000000001
1000000100100100D00000D000000111111100D00000D000000111111100D00000D000000111111100D00000D1
1000000100000100D000000000000100000100D000000000000100000100D000000000000100000100D0000001
1000000100000100D000000000000100000100D000000000000100000100D000000000000100000100D0000001
10000001C11C11000000000000000111111100000000000000011111110000000000000001C11C110000000001
100000000000000000000000000000000000000000000000000000000000000000000000000000000000000001
1000000000D000000000000000000000D000000000000000000000D000000000000000000000D0000000000001
10000000001000D00000D000000000001000D00000D000000000001000D00000D000000000001000D00000D001
10000000000000000000D000000000000000000000D000000000000000000000D000000000000000000000D001
100D0000000000000000D0000D0000000000000000D0000D0000000000000000D0000D0000000000000000D001
100000000000000000000000000000000000000000000000000000000000000000000000000000000000000001
100000000000000000000000000000000000000000000000000000000000000000000000000000000000000001
100000000000000000000000000000000000000000000000000000000000000000000000000000000000000001
100000000000000000000000000000000000000000000000000000000000000000000000000000000000000001
100000000000000000000000000000000000000000000000000000000000000000000000000000000000000001
100000000000000000000000000000000000000000000000000000000000000000000000000000000000000001
100000000000000000000000000000000000000000000000000000000000000000000000000000000000000001
100000000000000000000000000000000000000000000000000000000000000000000000000000000000000001
100000000000000000000000000000000000000000000000000000000000000000000000000000000000000001
100000000000000000000000000000000000000000000000000000000000000000000000000000000000000001
100000000000000000000000000000000000000000000000000000000000000000000000000000000000000001
100000000000000000000000000000000000000000000000000000000000000000000000000000000000000001
100000000000000000000000000000000000000000000000000000000000000000000000000000000000000001
100000000000000000000000000000000000000000000000000000000000000000000000000000000000000001
100000000000000000000000000000000000000000000000000000000000000000000000000000000000000001
100000000000000000000000000000000000000000000000000000000000000000000000000000000000000001
100000000000000000000000000000000000000000000000000000000000000000000000000000000000000001
100000000000000000000000000000000000000000000000000000000000000000000000000000000000000001
100000000000000000000000000000000000000000000000000000000000000000000000000000000000000001
100000000000000000000000000000000000000000000000000000000000000000000000000000000000000001
100000000000000000000000000000000000000000000000000000000000000000000000000000000000000001
100000011111111111111111111111111111000000000000000000000000000000000000000000000000000001
10000001                           1000000000000000000000000000000000000000000000000000001
10000001                           1000000000000000000000000000000000000000000000000000001
10000001                           1000000000000000000000000000000000000000000000000000001
100000011111111111111111111111111111000000000000000000000000000000000000000000000000000001
100000000000000000000000000000000000000000000000000000000000000000000000000000000000000001
111111111111111111111111111111111111111111111111111111111111111111111111111111111111111111