NO ./textures/blue.xpm

SO ./textures/brick.xpm

WE ./textures/grey.xpm

EA ./textures/wood.xpm

F 220,100,0

C 225,30,0

11111111111111111111
10000000000000000001
100E00000000000000D1
10000000100100000001
10000000000000000001
1000000111H11100D0D1
1000000100000100D001
1000000100000100D001
10000001C11C11000001
10000000000000000001
1000000000D000000001
11111111111111111111