NO ./path_to_the_north_texture

SO ./path_to_the_south_texture

WE ./path_to_the_west_texture

EA ./path_to_the_east_texture

F 220,100,0

C 225,30,0

111111111111H11111111111
100000000000000000000001
100000000000000000000001
100010000000000000000001
100000000000000000000001
100000000000000000000001
100000000000000000DDDDD1
1000000010E1000000000001
100000000000000000000001
1000000111H11100D00000D1
1000000100000100D0000001
1000000100000100D0000001
10000001C1HC110000000001
100000000000000000000001
1000000000D0000000000001
111111111111111111111111